Luisa Reimann	w
Oskar Henri Knaier	m
Jakob Schwabe	m
Nico Philipp Kronenberger	m
Will Unger	m
Alexander Graiche	m
Sophie Kliem	w
Melina Papapetrou	w
Helena Condic	w
Samuel Grube	m
Nea Louise Benner	w
Bendix Bundt	m
Jana Nagel	w
Bastian Lutz	m
Siri Engelbrecht	w
Smilla Engelbrecht	w
Moritz Heitmann	m
Niklas Martin Berberich	m
Nina HÃ¶hn	w
Marwan Mikkawi	m
Lius Wolf	m
Thia Markov	w
Dalia Pepeljak	w
